No,Bulan ,Eksekutif,Bisnis,Ekonomi,Total,Tujuan
1,Januari,204866,18001,295484,518351," DAOP 1 (Jakarta), DAOP 3 (Cirebon), DAOP 4 (Semarang) , DAOP 5 (Purwokerto), DAOP 6 (Yogyakarta), DAOP 7 (Madiun),  DAOP 8 (Surabaya), DAOP 9 (Jember)  "
2,Februari,181678,14617,240850,437145," DAOP 1 (Jakarta), DAOP 3 (Cirebon), DAOP 4 (Semarang) , DAOP 5 (Purwokerto), DAOP 6 (Yogyakarta), DAOP 7 (Madiun),  DAOP 8 (Surabaya), DAOP 9 (Jember)  "
3,Maret ,207728,15295,257000,480023," DAOP 1 (Jakarta), DAOP 3 (Cirebon), DAOP 4 (Semarang) , DAOP 5 (Purwokerto), DAOP 6 (Yogyakarta), DAOP 7 (Madiun),  DAOP 8 (Surabaya), DAOP 9 (Jember)  "
4,April,204595,8739,261996,475330," DAOP 1 (Jakarta), DAOP 3 (Cirebon), DAOP 4 (Semarang) , DAOP 5 (Purwokerto), DAOP 6 (Yogyakarta), DAOP 7 (Madiun),  DAOP 8 (Surabaya), DAOP 9 (Jember)  "
5,Mei,186753,8066,218268,413087," DAOP 1 (Jakarta), DAOP 3 (Cirebon), DAOP 4 (Semarang) , DAOP 5 (Purwokerto), DAOP 6 (Yogyakarta), DAOP 7 (Madiun),  DAOP 8 (Surabaya), DAOP 9 (Jember)  "
6,Juni,209515,23116,304010,536641," DAOP 1 (Jakarta), DAOP 3 (Cirebon), DAOP 4 (Semarang) , DAOP 5 (Purwokerto), DAOP 6 (Yogyakarta), DAOP 7 (Madiun),  DAOP 8 (Surabaya), DAOP 9 (Jember)  "
7,Juli,204178,12415,271792,488385," DAOP 1 (Jakarta), DAOP 3 (Cirebon), DAOP 4 (Semarang) , DAOP 5 (Purwokerto), DAOP 6 (Yogyakarta), DAOP 7 (Madiun),  DAOP 8 (Surabaya), DAOP 9 (Jember)  "
8,Agustus,200963,11065,270578,482606," DAOP 1 (Jakarta), DAOP 3 (Cirebon), DAOP 4 (Semarang) , DAOP 5 (Purwokerto), DAOP 6 (Yogyakarta), DAOP 7 (Madiun),  DAOP 8 (Surabaya), DAOP 9 (Jember)  "
9,September,190537,10137,246629,447303," DAOP 1 (Jakarta), DAOP 3 (Cirebon), DAOP 4 (Semarang) , DAOP 5 (Purwokerto), DAOP 6 (Yogyakarta), DAOP 7 (Madiun),  DAOP 8 (Surabaya), DAOP 9 (Jember)  "
10,Oktober,193755,10221,246552,450528," DAOP 1 (Jakarta), DAOP 3 (Cirebon), DAOP 4 (Semarang) , DAOP 5 (Purwokerto), DAOP 6 (Yogyakarta), DAOP 7 (Madiun),  DAOP 8 (Surabaya), DAOP 9 (Jember)  "
11,November,204595,8739,261996,475330," DAOP 1 (Jakarta), DAOP 3 (Cirebon), DAOP 4 (Semarang) , DAOP 5 (Purwokerto), DAOP 6 (Yogyakarta), DAOP 7 (Madiun),  DAOP 8 (Surabaya), DAOP 9 (Jember)  "
12,Desember,207728,15295,257000,480023," DAOP 1 (Jakarta), DAOP 3 (Cirebon), DAOP 4 (Semarang) , DAOP 5 (Purwokerto), DAOP 6 (Yogyakarta), DAOP 7 (Madiun),  DAOP 8 (Surabaya), DAOP 9 (Jember)  "